{
    "width": 16,
    "height": 16,
    "walls": [
        [1,1,1,1,1,1,1,1,1,1,1,1,1,1,1,1],
        [1,0,0,0,0,0,0,0,0,0,0,0,0,0,0,1],
        [1,0,0,0,0,0,0,0,0,0,0,0,0,0,0,1],
        [1,0,0,2,2,2,0,0,0,3,3,3,0,0,0,1],
        [1,0,0,2,0,0,0,0,0,0,0,3,0,0,0,1],
        [1,0,0,2,0,0,0,0,0,0,0,3,0,0,0,1],
        [1,0,0,0,0,0,0,0,0,0,0,0,0,0,0,1],
        [1,0,0,0,0,0,0,0,0,0,0,0,0,0,0,1],
        [1,0,0,0,0,0,0,0,0,0,0,0,0,0,0,1],
        [1,0,0,4,0,0,0,0,0,0,0,4,0,0,0,1],
        [1,0,0,4,0,0,0,0,0,0,0,4,0,0,0,1],
        [1,0,0,4,4,0,0,0,0,0,4,4,0,0,0,1],
        [1,0,0,0,0,0,0,0,0,0,0,0,0,0,0,1],
        [1,0,0,0,0,0,0,0,0,0,0,0,0,0,0,1],
        [1,0,0,0,0,0,0,0,0,0,0,0,0,0,0,1],
        [1,1,1,1,1,1,1,1,1,1,1,1,1,1,1,1]
    ],
    "doors": [],
    "pushwalls": [],
    "entities": [],
    "playerStart": { "x": 8, "y": 8, "angle": 0 },
    "exitTile": { "x": 14, "y": 14 }
}
